111111111111111
10010000E000C01
100000000001111
1001000C0000001
10P100C00100001
111111111111111