111111111111111
10010000E0000X1
1P0000000001111
10C1X00A0000X01
100100X11000011
111111111111111