111111111111111
1C010000E0000X1
10C00A000001111
10C1X001100X0C1
1P01C0X11000011
111111111111111