111111111111111
10PCEO000000001
100000000000001
111111111111111